8,5,5,5,5,5,5,5,5,5,5,11
4,15,12,12,12,15,12,12,12,12,15,6
4,12,12,15,12,12,12,20,12,15,12,6
4,12,12,20,12,12,15,12,12,21,14,6
4,12,12,12,17,12,15,12,12,14,12,6
4,15,14,15,12,12,15,12,21,12,12,6
4,20,13,14,15,12,12,12,15,14,13,6
9,7,7,7,7,7,7,7,7,7,7,10
